Framenumber;Time [s];Video pixel (X) [px];Video pixel (Y) [px];X position [px];Y position [px];Distance [px];Distance in x-direction [px];Distance in y-direction [px];Length [px];Length in x-Direction [px];Length in y-Direction [px];Velocity [px/s];Velocity in x-direction [px/s];Velocity in y-direction [px/s];Acceleration [px/s²];Acceleration in x-Direction [px/s²];Acceleration in y-Direction [px/s²];
2;0.02;189;361;189;361;60.81;43;43;60.81;43;43;1520.28;1075;1075;-7773.52;3125;-30625;
4;0.06;232;404;232;404;24.19;24;-3;85;67;40;1209.34;1200;-150;14668.36;-113750;-45000;
5;0.08;256;401;256;401;60.11;-43;-42;145.11;24;-2;1502.71;-1075;-1050;2709.71;53750;56250;
7;0.12;213;359;213;359;64.44;43;48;209.55;67;46;1611.09;1075;1200;-31527.36;-26875;-38750;
9;0.16;256;407;256;407;7;0;-7;216.55;67;39;350;0;-350;160439.6;12500;-160000;
10;0.18;256;400;256;400;71.18;5;-71;287.73;72;-32;3558.79;250;-3550;-73626.37;-85000;252500;
11;0.2;261;329;261;329;41.73;-29;30;329.45;43;-2;2086.26;-1450;1500;-18462.71;136250;-17500;
12;0.22;232;359;232;359;68.68;51;46;398.13;94;44;1717.01;1275;1150;-36193.81;-34375;-22500;
14;0.26;283;405;283;405;5.39;-2;5;403.52;92;49;269.26;-100;250;57115.06;-22500;-77500;
15;0.28;281;410;281;410;56.46;-22;-52;459.98;70;-3;1411.56;-550;-1300;5408.07;43750;60000;
17;0.32;259;358;259;358;65.12;48;44;525.09;118;41;1627.88;1200;1100;-25490.15;-32500;-12500;
19;0.36;307;402;307;402;12.17;-2;12;537.26;116;53;608.28;-100;600;46244.93;-26250;-100000;
20;0.38;305;414;305;414;61.33;-25;-56;598.59;91;-3;1533.17;-625;-1400;8428.82;52500;63750;
22;0.42;280;358;280;358;74.81;59;46;673.4;150;43;1870.33;1475;1150;-31095.73;-29375;-42500;
24;0.46;339;404;339;404;12.53;6;-11;685.93;156;32;626.5;300;-550;39407.86;-63750;-23750;
25;0.48;345;393;345;393;56.59;-39;-41;742.52;117;-9;1414.66;-975;-1025;8968.98;58125;54375;
27;0.52;306;352;306;352;70.94;54;46;813.45;171;37;1773.41;1350;1150;-35496.53;-42500;-30000;
29;0.56;360;398;360;398;7.07;-7;-1;820.52;164;36;353.55;-350;-50;59154.13;-11250;-68750;
30;0.58;353;397;353;397;61.47;-23;-57;881.99;141;-21;1536.64;-575;-1425;13763.18;50000;73750;
32;0.62;330;340;330;340;83.49;57;61;965.48;198;40;2087.16;1425;1525;-40654.65;-24375;-40625;
34;0.66;387;401;387;401;9.22;9;-2;974.7;207;38;460.98;450;-100;69222.82;-76250;-70000;
35;0.68;396;399;396;399;73.82;-43;-60;1048.51;164;-22;1845.43;-1075;-1500;5618.54;65000;72500;
37;0.72;353;339;353;339;82.81;61;56;1131.32;225;34;2070.18;1525;1400;-32673.96;-54375;-25000;
39;0.76;414;395;414;395;15.26;-13;8;1146.58;212;42;763.22;-650;400;47279.19;2500;-100000;
40;0.78;401;403;401;403;68.35;-24;-64;1214.94;188;-22;1708.8;-600;-1600;8575.69;52500;75000;
42;0.82;377;339;377;339;82.07;60;56;1297.01;248;34;2051.83;1500;1400;-37320.29;-25000;-28750;
44;0.86;437;395;437;395;11.18;10;5;1308.19;258;39;559.02;500;250;62577.12;-77500;-86250;
45;0.88;447;400;447;400;72.42;-42;-59;1380.61;216;-20;1810.56;-1050;-1475;1590.18;60000;69375;
47;0.92;405;341;405;341;74.97;54;52;1455.58;270;32;1874.17;1350;1300;-32601.97;-20000;-28750;
49;0.96;459;393;459;393;11.4;11;3;1466.98;281;35;570.09;550;150;66248.58;-83750;-83750;
50;0.98;470;396;470;396;75.8;-45;-61;1542.78;236;-26;1895.06;-1125;-1525;7431.42;66250;77500;
52;1.02;425;335;425;335;87.69;61;63;1630.48;297;37;2192.32;1525;1575;-38366.72;-21875;-41875;
54;1.06;486;398;486;398;13.15;13;-2;1643.63;310;35;657.65;650;-100;57429.59;-92500;-62500;
55;1.08;499;396;499;396;72.25;-48;-54;1715.88;262;-19;1806.24;-1200;-1350;5233.13;65000;70000;
57;1.12;451;342;451;342;80.62;56;58;1796.5;318;39;2015.56;1400;1450;-24619.7;-11250;-26250;
59;1.16;507;400;507;400;20.62;19;8;1817.12;337;47;1030.78;950;400;58034.21;-110000;-110000;
60;1.18;526;408;526;408;87.66;-50;-72;1904.77;287;-25;2191.46;-1250;-1800;-5281.15;66875;79375;
62;1.22;476;336;476;336;79.21;57;55;1983.98;344;30;1980.21;1425;1375;-22463.73;-13125;-19375;
64;1.26;533;391;533;391;21.63;18;12;2005.62;362;42;1081.67;900;600;51169.4;-108750;-113750;
65;1.28;551;403;551;403;84.2;-51;-67;2089.82;311;-25;2105.05;-1275;-1675;-1170.95;65000;81250;
67;1.32;500;336;500;336;82.33;53;63;2172.15;364;38;2058.22;1325;1575;-27313.87;-10625;-48125;
69;1.36;553;399;553;399;19.31;18;-7;2191.46;382;31;965.66;900;-350;42149.97;-103750;-51250;
70;1.38;571;392;571;392;72.35;-47;-55;2263.81;335;-24;1808.66;-1175;-1375;5608.73;65625;70000;
72;1.42;524;337;524;337;81.32;58;57;2345.13;393;33;2033.01;1450;1425;-32927.95;-18750;-31875;
74;1.46;582;394;582;394;14.32;14;3;2359.44;407;36;715.89;700;150;61038.1;-96250;-82500;
75;1.48;596;397;596;397;77.47;-49;-60;2436.91;358;-24;1936.65;-1225;-1500;1081.15;65625;72500;
77;1.52;547;337;547;337;79.2;56;56;2516.11;414;32;1979.9;1400;1400;-30747.47;-20000;-23750;
79;1.56;603;393;603;393;15;12;9;2531.11;426;41;750;600;450;64794;-85000;-108750;
80;1.58;615;402;615;402;81.84;-44;-69;2612.94;382;-28;2045.88;-1100;-1725;-321.78;63750;78750;
82;1.62;571;333;571;333;81.32;58;57;2694.26;440;29;2033.01;1450;1425;-33459.67;-21250;-26875;
84;1.66;629;390;629;390;13.89;12;7;2708.15;452;36;694.62;600;350;61323.89;-85000;-96250;
85;1.68;641;397;641;397;76.84;-44;-63;2785;408;-27;1921.1;-1100;-1575;1030.02;61875;74375;
87;1.72;597;334;597;334;78.49;55;56;2863.49;463;29;1962.3;1375;1400;-25705.6;-11875;-28750;
89;1.76;652;390;652;390;18.68;18;5;2882.17;481;34;934.08;900;250;54298.93;-105000;-93750;
90;1.78;670;395;670;395;80.8;-48;-65;2962.97;433;-31;2020.06;-1200;-1625;1647.73;66875;77500;
92;1.82;622;330;622;330;83.44;59;59;3046.41;492;28;2085.97;1475;1475;-37045.32;-23125;-30625;
94;1.86;681;389;681;389;12.08;11;5;3058.5;503;33;604.15;550;250;65554.13;-83750;-90000;
95;1.88;692;394;692;394;76.61;-45;-62;3135.11;458;-29;1915.23;-1125;-1550;309.02;63125;71875;
97;1.92;647;332;647;332;77.1;56;53;3212.21;514;24;1927.6;1400;1325;-15762.09;-6250;-18125;
99;1.96;703;385;703;385;25.94;23;12;3238.15;537;36;1297.11;1150;600;40508.34;-127500;-108750;
100;1.98;726;397;726;397;84.29;-56;-63;3322.44;481;-27;2107.28;-1400;-1575;-4919.54;70000;71875;
102;2.02;670;334;670;334;76.42;56;52;3398.86;537;25;1910.5;1400;1300;-21482.69;-11250;-21250;
104;2.06;726;386;726;386;21.02;19;9;3419.89;556;34;1051.19;950;450;52470.27;-112500;-105000;
105;2.08;745;395;745;395;84.02;-52;-66;3503.91;504;-32;2100.6;-1300;-1650;-2125.77;68750;76250;
107;2.12;693;329;693;329;80.62;58;56;3584.53;562;24;2015.56;1450;1400;-20181.5;-8750;-22500;
109;2.16;751;385;751;385;24.17;22;10;3608.7;584;34;1208.3;1100;500;47353.33;-121250;-110000;
110;2.18;773;395;773;395;86.21;-53;-68;3694.91;531;-34;2155.37;-1325;-1700;-3495.17;68125;78750;
112;2.22;720;327;720;327;80.62;56;58;3775.54;587;24;2015.56;1400;1450;-24288.34;-10000;-28750;
114;2.26;776;385;776;385;20.88;20;6;3796.42;607;30;1044.03;1000;300;33648.99;-113750;-72500;
115;2.28;796;391;796;391;68.68;-51;-46;3865.1;556;-16;1717.01;-1275;-1150;-3175.07;63750;52500;
117;2.32;745;345;745;345;63.6;51;38;3928.7;607;22;1590.01;1275;950;-13263.17;-6875;-15000;
119;2.36;796;383;796;383;21.19;20;7;3949.89;627;29;1059.48;1000;350;40341.61;-108750;-90000;
120;2.38;816;390;816;390;74.65;-47;-58;4024.54;580;-29;1866.31;-1175;-1450;-619.46;63750;66875;
122;2.42;769;332;769;332;73.66;55;49;4098.2;635;20;1841.53;1375;1225;-22026.65;-15625;-15625;
124;2.46;824;381;824;381;19.21;15;12;4117.41;650;32;960.47;750;600;52801.29;-111250;-98750;
125;2.48;839;393;839;393;80.66;-59;-55;4198.07;591;-23;2016.49;-1475;-1375;-11057.21;63750;63125;
127;2.52;780;338;780;338;62.97;43;46;4261.04;634;23;1574.21;1075;1150;-11940.51;-6875;-10000;
129;2.56;823;384;823;384;21.93;16;15;4282.97;650;38;1096.59;800;750;58803.9;-112500;-125000;
130;2.58;839;399;839;399;90.91;-58;-70;4373.88;592;-32;2272.66;-1450;-1750;-12587.08;66250;76250;
132;2.62;781;329;781;329;70.77;48;52;4444.64;640;20;1769.18;1200;1300;-27979.52;-23750;-17500;
134;2.66;829;381;829;381;13;5;12;4457.64;645;32;650;250;600;68819.42;-76250;-108750;
135;2.68;834;393;834;393;81.06;-51;-63;4538.7;594;-31;2026.39;-1275;-1575;57253.74;78125;136875;
137;2.72;783;330;783;330;86.33;37;78;4625.03;631;47;4316.54;1850;3900;-149400.25;-70000;-257500;
138;2.74;820;408;820;408;26.57;9;-25;4651.6;640;22;1328.53;450;-1250;-28926.65;0;92500;
139;2.76;829;383;829;383;15;9;12;4666.6;649;34;750;450;600;67982.52;-91250;-110000;
140;2.78;838;395;838;395;84.39;-55;-64;4750.99;594;-30;2109.65;-1375;-1600;-6318.44;66250;73750;
142;2.82;783;331;783;331;74.28;51;54;4825.26;645;24;1856.91;1275;1350;-26267.17;-14375;-23750;
144;2.86;834;385;834;385;16.12;14;8;4841.39;659;32;806.23;700;400;70177.68;-112500;-98750;
145;2.88;848;393;848;393;88.39;-62;-63;4929.78;597;-31;2209.78;-1550;-1575;-11925.18;68750;70625;
147;2.92;786;330;786;330;69.31;48;50;4999.09;645;19;1732.77;1200;1250;-13085.84;-3750;-16250;
149;2.96;834;380;834;380;24.19;21;12;5023.28;666;31;1209.34;1050;600;53584.86;-135000;-108750;
150;2.98;855;392;855;392;91.24;-66;-63;5114.52;600;-32;2281.04;-1650;-1575;-9263.47;73750;74375;
152;3.02;789;329;789;329;76.42;52;56;5190.94;652;24;1910.5;1300;1400;-36443.2;-31250;-23750;
154;3.06;841;385;841;385;9.06;1;9;5199.99;653;33;452.77;50;450;74781.38;-56250;-103750;
155;3.08;842;394;842;394;77.94;-43;-65;5277.93;610;-32;1948.4;-1075;-1625;-5318.53;55625;73125;
157;3.12;799;329;799;329;69.43;46;52;5347.36;656;20;1735.66;1150;1300;-13890.33;-5000;-15000;
159;3.16;845;381;845;381;23.6;19;14;5370.96;675;34;1180.04;950;700;54259.19;-123750;-118750;
160;3.18;864;395;864;395;90.61;-61;-67;5461.57;614;-33;2265.23;-1525;-1675;-9709.85;69375;76875;
162;3.22;803;328;803;328;75.07;50;56;5536.64;664;23;1876.83;1250;1400;-24560.13;-11250;-25000;
164;3.26;853;384;853;384;17.89;16;8;5554.53;680;31;894.43;800;400;64172.22;-112500;-101250;
165;3.28;869;392;869;392;87.11;-58;-65;5641.64;622;-34;2177.87;-1450;-1625;-7872.76;66250;76250;
167;3.32;811;327;811;327;74.52;48;57;5716.16;670;23;1862.96;1200;1425;-23322.69;-16250;-16875;
169;3.36;859;384;859;384;18.6;11;15;5734.76;681;38;930.05;550;750;67274.78;-93750;-130000;
170;3.38;870;399;870;399;91.02;-53;-74;5825.78;628;-36;2275.55;-1325;-1850;-10465.92;65000;80000;
172;3.42;817;325;817;325;74.28;51;54;5900.06;679;18;1856.91;1275;1350;-22837.87;-19375;-13750;
174;3.46;868;379;868;379;18.87;10;16;5918.93;689;34;943.4;500;800;58638;-91250;-122500;
175;3.48;878;395;878;395;84.65;-53;-66;6003.57;636;-32;2116.16;-1325;-1650;-7364.65;64375;74375;
177;3.52;825;329;825;329;72.86;50;53;6076.44;686;21;1821.57;1250;1325;-18124.66;-12500;-13125;
179;3.56;875;382;875;382;21.93;15;16;6098.37;701;37;1096.59;750;800;60564.07;-111250;-128750;
180;3.58;890;398;890;398;92.31;-59;-71;6190.68;642;-34;2307.87;-1475;-1775;-11273.86;70625;76250;
182;3.62;831;327;831;327;74.28;54;51;6264.96;696;17;1856.91;1350;1275;-20653.41;-17500;-11875;
184;3.66;885;378;885;378;20.62;13;16;6285.58;709;33;1030.78;650;800;62094.36;-105000;-127500;
185;3.68;898;394;898;394;90.91;-58;-70;6376.48;651;-37;2272.66;-1450;-1750;-10242.56;66250;79375;
187;3.72;840;324;840;324;74.52;48;57;6451;699;20;1862.96;1200;1425;-21762.24;-11250;-19375;
189;3.76;888;381;888;381;19.85;15;13;6470.85;714;33;992.47;750;650;58730.58;-106250;-116250;
190;3.78;903;394;903;394;86.68;-55;-67;6557.53;659;-34;2167.08;-1375;-1675;-9064.38;65000;75000;
192;3.82;848;327;848;327;72.18;49;53;6629.71;708;19;1804.51;1225;1325;-22578.01;-18125;-14375;
194;3.86;897;380;897;380;18.03;10;15;6647.74;718;34;901.39;500;750;60435.35;-87500;-122500;
195;3.88;907;395;907;395;84.4;-50;-68;6732.15;668;-34;2110.09;-1250;-1700;-8478.72;60625;75625;
197;3.92;857;327;857;327;70.84;47;53;6802.98;715;19;1770.95;1175;1325;-15934.19;-8125;-14375;
199;3.96;904;380;904;380;22.67;17;15;6825.66;732;34;1133.58;850;750;53150.49;-115000;-120000;
200;3.98;921;395;921;395;87.86;-58;-66;6913.52;674;-32;2196.59;-1450;-1650;-11160.24;66875;72500;
202;4.02;863;329;863;329;70.01;49;50;6983.53;723;18;1750.18;1225;1250;-18443.89;-16875;-10000;
204;4.06;912;379;912;379;20.25;11;17;7003.77;734;35;1012.42;550;850;56944.25;-95000;-126250;
205;4.08;923;396;923;396;86.05;-54;-67;7089.83;680;-32;2151.31;-1350;-1675;-10028.23;65000;72500;
207;4.12;869;329;869;329;70.01;50;49;7159.83;730;17;1750.18;1250;1225;-14572.92;-10000;-10625;
209;4.16;919;378;919;378;23.35;17;16;7183.18;747;33;1167.26;850;800;52408.35;-115000;-123750;
210;4.18;936;394;936;394;88.62;-58;-67;7271.8;689;-34;2215.43;-1450;-1675;-10747.42;68125;73125;
212;4.22;878;327;878;327;71.42;51;50;7343.22;740;16;1785.53;1275;1250;-17223.66;-13125;-11250;
214;4.26;929;377;929;377;21.93;15;16;7365.15;755;32;1096.59;750;800;53978.18;-111250;-120000;
215;4.28;944;393;944;393;87.05;-59;-64;7452.2;696;-32;2176.15;-1475;-1600;-10200.72;67500;71875;
217;4.32;885;329;885;329;70.72;49;51;7522.92;745;19;1768.12;1225;1275;-19454.27;-13125;-14375;
219;4.36;934;380;934;380;19.8;14;14;7542.72;759;33;989.95;700;700;61012.71;-102500;-122500;
220;4.38;948;394;948;394;88.41;-54;-70;7631.13;705;-37;2210.2;-1350;-1750;-16059.62;62083.33;70833.33;
222;4.42;894;324;894;324;94.07;68;65;7725.2;773;28;1567.82;1133.33;1083.33;10403.54;-44722.22;-43888.89;
225;4.48;962;389;962;389;87.68;-62;-62;7812.88;711;-34;2192.03;-1550;-1550;-9714.05;70000;71250;
227;4.52;900;327;900;327;72.14;50;52;7885.02;761;18;1803.47;1250;1300;-10513.43;-8750;-6250;
229;4.56;950;379;950;379;27.66;18;21;7912.67;779;39;1382.93;900;1050;48970.15;-120000;-143750;
230;4.58;968;400;968;400;94.49;-60;-73;8007.17;719;-34;2362.33;-1500;-1825;-14420.06;68750;77500;
232;4.62;908;327;908;327;71.42;50;51;8078.59;769;17;1785.53;1250;1275;-21657.33;-15000;-15625;
234;4.66;958;378;958;378;18.38;13;13;8096.97;782;30;919.24;650;650;57908.47;-98750;-112500;
235;4.68;971;391;971;391;83.1;-53;-64;8180.07;729;-34;2077.41;-1325;-1600;-9929.81;61875;70625;
237;4.72;918;327;918;327;67.21;46;49;8247.28;775;15;1680.22;1150;1225;-13721.12;-8750;-10625;
239;4.76;964;376;964;376;22.63;16;16;8269.91;791;31;1131.37;800;800;54343.87;-111250;-125000;
240;4.78;980;392;980;392;88.73;-57;-68;8358.64;734;-37;2218.25;-1425;-1700;-8535.39;66875;77500;
242;4.82;923;324;923;324;75.07;50;56;8433.71;784;19;1876.83;1250;1400;-25054.74;-12500;-23750;
244;4.86;973;380;973;380;17.49;15;9;8451.2;799;28;874.64;750;450;61483.41;-110000;-98750;
245;4.88;988;389;988;389;84.17;-58;-61;8535.38;741;-33;2104.31;-1450;-1525;-13956.47;65000;63958.33;
247;4.92;930;328;930;328;92.76;69;62;8628.14;810;29;1546.05;1150;1033.33;11963.23;-45000;-44722.22;
250;4.98;999;390;999;390;90.55;-62;-66;8718.69;748;-37;2263.85;-1550;-1650;-10625.72;70625;74375;
252;5.02;937;324;937;324;73.55;51;53;8792.24;799;16;1838.82;1275;1325;-21158.65;-15625;-14375;
254;5.06;988;377;988;377;19.85;13;15;8812.09;812;31;992.47;650;750;57621.75;-102500;-118750;
255;5.08;1001;392;1001;392;85.8;-56;-65;8897.89;756;-34;2144.91;-1400;-1625;-13535.96;62500;69791.67;
257;5.12;945;327;945;327;96.21;66;70;8994.1;822;36;1603.47;1100;1166.67;11374.9;-43333.33;-48194.44;
260;5.18;1011;397;1011;397;91.44;-60;-69;9085.54;762;-33;2285.96;-1500;-1725;51305.99;85000;140625;
262;5.22;951;328;951;328;86.76;38;78;9172.3;800;45;4338.2;1900;3900;-178892.85;-61250;-212500;
263;5.24;989;406;989;406;30.41;27;-14;9202.72;827;31;760.35;675;-350;36140.31;-51250;-34375;
265;5.28;1016;392;1016;392;88.24;-55;-69;9290.95;772;-38;2205.96;-1375;-1725;-15962.34;61875;71041.67;
267;5.32;961;323;961;323;94.05;66;67;9385;838;29;1567.46;1100;1116.67;11629.37;-43750;-46527.78;
270;5.38;1027;390;1027;390;90.61;-61;-67;9475.61;777;-38;2265.23;-1525;-1675;-11091.35;69375;75000;
272;5.42;966;323;966;323;72.86;50;53;9548.47;827;15;1821.57;1250;1325;-17199.84;-10000;-14375;
274;5.46;1016;376;1016;376;22.67;17;15;9571.14;844;30;1133.58;850;750;52128.54;-116250;-117500;
275;5.48;1033;391;1033;391;87.05;-59;-64;9658.19;785;-34;2176.15;-1475;-1600;-15352.48;61875;70000;
277;5.52;974;327;974;327;93.72;60;72;9751.91;845;38;1562.05;1000;1200;12572.2;-38750;-51666.67;
280;5.58;1034;399;1034;399;92.66;-53;-76;9844.57;792;-38;2316.38;-1325;-1900;-17233.83;61041.67;77083.33;
282;5.62;981;323;981;323;97.62;67;71;9942.19;859;33;1627.03;1116.67;1183.33;11027.77;-43194.44;-48888.89;
285;5.68;1048;394;1048;394;91.55;-59;-70;10033.74;800;-37;2288.7;-1475;-1750;-16178.35;63958.33;74583.33;
287;5.72;989;324;989;324;98.49;65;74;10132.23;865;37;1641.56;1083.33;1233.33;11163.73;-42222.22;-50555.56;
290;5.78;1054;398;1054;398;92.46;-58;-72;10224.69;807;-35;2311.38;-1450;-1800;-14465.31;66250;76250;
292;5.82;996;326;996;326;69.31;48;50;10294;855;15;1732.77;1200;1250;-8296.99;-10000;-2500;
294;5.86;1044;376;1044;376;28.02;16;23;10322.02;871;38;1400.89;800;1150;44962.16;-110000;-148750;
295;5.88;1060;399;1060;399;92.01;-56;-73;10414.02;815;-35;2300.14;-1400;-1825;-13748.93;66250;76250;
297;5.92;1004;326;1004;326;70.01;50;49;10484.03;865;14;1750.18;1250;1225;-19100.61;-18750;-9375;
299;5.96;1054;375;1054;375;19.72;10;17;10503.75;875;31;986.15;500;850;61773.63;-95000;-128750;
300;5.98;1064;392;1064;392;88.87;-56;-69;10592.62;819;-38;2221.63;-1400;-1725;-14577.86;63333.33;72708.33;
302;6.02;1008;323;1008;323;98.31;68;71;10690.93;887;33;1638.51;1133.33;1183.33;10628.73;-42638.89;-49305.56;
305;6.08;1076;394;1076;394;91.05;-57;-71;10781.98;830;-38;2276.24;-1425;-1775;-17666.16;61875;73541.67;
307;6.12;1019;323;1019;323;94.18;63;70;10876.15;893;32;1569.59;1050;1166.67;11191.73;-40833.33;-48611.11;
310;6.18;1082;393;1082;393;89.64;-56;-70;10965.8;837;-38;2241.09;-1400;-1750;-18469.51;59166.67;72500;
312;6.22;1026;323;1026;323;90.14;58;69;11055.94;895;31;1502.31;966.67;1150;10629.67;-37777.78;-47500;
315;6.28;1084;392;1084;392;85.6;-52;-68;11141.54;843;-37;2140.09;-1300;-1700;-11039.12;61250;73750;
317;6.32;1032;324;1032;324;101.91;69;75;11243.45;912;38;1698.53;1150;1250;12036.92;-44166.67;-52500;
320;6.38;1101;399;1101;399;96.83;-60;-76;11340.28;852;-38;2420.74;-1500;-1900;-21927.97;61250;77916.67;
322;6.42;1041;323;1041;323;92.62;57;73;11432.9;909;35;1543.62;950;1216.67;10023.79;-37083.33;-49027.78;
325;6.48;1098;396;1098;396;85.8;-51;-69;11518.7;858;-34;2145.05;-1275;-1725;0;0;0;
327;6.52;1047;327;1047;327;0;0;0;0;0;0;0;0;0;0;0;0;
